Date,Description,Type,Amount,Balance
2025-04-20,Payroll Deposit,Credit,530,530
2025-04-21,Online Shopping,Debit,180,350
2025-04-22,Transit Pass,Debit,55,295
2025-04-23,Netflix Annual,Debit,299,-4
2025-04-23,Overdraft Fee,Debit,35,-39
2025-04-24,Bonus Credit,Credit,100,61
