Date,Description,Type,Amount,Balance
2025-04-20,Payroll Deposit,Credit,480.0,480.0
2025-04-21,ATM Withdrawal,Debit,200.0,280.0
2025-04-22,Amazon Purchase,Debit,150.0,130.0
2025-04-23,Coffee Shop,Debit,10.25,119.75
2025-04-24,LinkedIn Premium (Annual),Debit,129.0,-9.25
2025-04-24,Overdraft Fee,Debit,35.0,-44.25
2025-04-25,Utility Rebate,Credit,75.0,30.75
