Date,Description,Type,Amount,Balance
2025-04-20,Payroll Deposit,Credit,510.0,510.0
2025-04-21,Restaurant,Debit,80.0,430.0
2025-04-22,Transit Pass,Debit,50.0,380.0
2025-04-23,Adobe Creative Cloud,Debit,389.99,-9.99
2025-04-23,Overdraft Fee,Debit,35.0,-44.99
2025-04-24,Cash Deposit,Credit,100.0,55.01
