Date,Description,Type,Amount,Balance
2025-04-20,Payroll Deposit,Credit,450.0,450.0
2025-04-21,Online Shopping,Debit,180.0,270.0
2025-04-22,Grocery Store,Debit,99.99,170.01
2025-04-23,Spotify Family Plan,Debit,179.99,-9.98
2025-04-23,Overdraft Fee,Debit,35.0,-44.98
2025-04-24,Bonus Credit,Credit,90.0,45.02
