Date,Description,Type,Amount,Balance
2025-04-20,Payroll Deposit,Credit,490.0,490.0
2025-04-21,Grocery Store,Debit,125.0,365.0
2025-04-22,Coffee Shop,Debit,8.25,356.75
2025-04-23,Amazon Prime (Annual),Debit,359.0,-2.25
2025-04-23,Overdraft Fee,Debit,35.0,-37.25
2025-04-24,Utility Rebate,Credit,75.0,37.75
