Date,Description,Type,Amount,Balance
2025-04-20,Payroll Deposit,Credit,465.0,465.0
2025-04-21,Restaurant,Debit,80.0,385.0
2025-04-22,Online Shopping,Debit,290.5,94.5
2025-04-23,Grocery Store,Debit,98.5,-4.0
2025-04-23,Overdraft Fee,Debit,35.0,-39.0
2025-04-24,Cash Deposit,Credit,100.0,61.0
